{
    "object-groups": [
        "cinematics/objectgroup"
    ],
    "tiles": [
        {
            "id": "forgetunnelext",
            "rotations": [0]
        },
        {
            "id": "forge01",
            "entry-door" : "enter"
        },
        {
            "id": "forge02",
            "entry-door" : "enter"
        },
        {
            "id": "forge03",
            "entry-door" : "enter"
        },
        {
            "id": "forge04"
        }        

    ],
/*

████████╗██╗██╗     ███████╗     ██████╗ ██████╗  ██████╗ ██╗   ██╗██████╗ ███████╗
╚══██╔══╝██║██║     ██╔════╝    ██╔════╝ ██╔══██╗██╔═══██╗██║   ██║██╔══██╗██╔════╝
   ██║   ██║██║     █████╗█████╗██║  ███╗██████╔╝██║   ██║██║   ██║██████╔╝███████╗
   ██║   ██║██║     ██╔══╝╚════╝██║   ██║██╔══██╗██║   ██║██║   ██║██╔═══╝ ╚════██║
   ██║   ██║███████╗███████╗    ╚██████╔╝██║  ██║╚██████╔╝╚██████╔╝██║     ███████║
   ╚═╝   ╚═╝╚══════╝╚══════╝     ╚═════╝ ╚═╝  ╚═╝ ╚═════╝  ╚═════╝ ╚═╝     ╚══════╝

*/
    "tile-groups": [
    ],
/*

 ██████╗██╗  ██╗ █████╗ ██╗     ██╗     ███████╗███╗   ██╗ ██████╗ ███████╗███████╗
██╔════╝██║  ██║██╔══██╗██║     ██║     ██╔════╝████╗  ██║██╔════╝ ██╔════╝██╔════╝
██║     ███████║███████║██║     ██║     █████╗  ██╔██╗ ██║██║  ███╗█████╗  ███████╗
██║     ██╔══██║██╔══██║██║     ██║     ██╔══╝  ██║╚██╗██║██║   ██║██╔══╝  ╚════██║
╚██████╗██║  ██║██║  ██║███████╗███████╗███████╗██║ ╚████║╚██████╔╝███████╗███████║
 ╚═════╝╚═╝  ╚═╝╚═╝  ╚═╝╚══════╝╚══════╝╚══════╝╚═╝  ╚═══╝ ╚═════╝ ╚══════╝╚══════╝

*/
 "challenges": [
        
    ]
}